//MAP CONVERTED BY dmm2tgm.py THIS HEADER COMMENT PREVENTS RECONVERSION, DO NOT REMOVE
"a" = (
/turf/open/space/basic,
/area/space)
"b" = (
/turf/closed/shuttle/ert{
	icon_state = "stan5"
	},
/area/space)
"c" = (
/turf/closed/shuttle/ert{
	icon_state = "stan20"
	},
/area/space)
"d" = (
/turf/closed/shuttle/ert,
/area/space)
"e" = (
/obj/effect/decal/warning_stripes{
	icon_state = "SW-out"
	},
/turf/open/floor/plating/almayer,
/area/space)
"f" = (
/turf/closed/shuttle/ert{
	icon_state = "stan1"
	},
/area/space)
"g" = (
/turf/closed/shuttle/ert{
	icon_state = "rightengine_3"
	},
/area/space)
"j" = (
/turf/closed/shuttle/ert{
	icon_state = "stan3"
	},
/area/space)
"k" = (
/turf/closed/shuttle/ert{
	icon_state = "stan22"
	},
/area/space)
"l" = (
/turf/closed/shuttle/ert{
	icon_state = "stan23"
	},
/area/space)
"m" = (
/turf/closed/shuttle/ert{
	icon_state = "stan_rightengine"
	},
/area/space)
"o" = (
/turf/closed/shuttle/ert{
	icon_state = "stan8"
	},
/area/space)
"p" = (
/obj/effect/decal/warning_stripes{
	icon_state = "SE-out"
	},
/turf/open/floor/plating/almayer,
/area/space)
"r" = (
/obj/docking_port/stationary/emergency_response/idle_port1,
/turf/open/floor/plating,
/area/space)
"t" = (
/turf/closed/shuttle/ert{
	icon_state = "stan_inner_w_2"
	},
/area/space)
"u" = (
/obj/effect/decal/warning_stripes{
	icon_state = "W"
	},
/turf/open/floor/plating/almayer,
/area/space)
"v" = (
/turf/closed/shuttle/ert{
	icon_state = "stan_inner_t_left"
	},
/area/space)
"w" = (
/turf/closed/shuttle/ert{
	icon_state = "stan9"
	},
/area/space)
"x" = (
/obj/effect/decal/warning_stripes{
	icon_state = "E"
	},
/turf/open/floor/plating/almayer,
/area/space)
"y" = (
/obj/effect/decal/warning_stripes{
	icon_state = "NW-out"
	},
/turf/open/floor/plating/almayer,
/area/space)
"z" = (
/turf/closed/shuttle/ert{
	icon_state = "leftengine_2";
	opacity = 0
	},
/area/space)
"C" = (
/obj/structure/machinery/door/poddoor/almayer{
	id = "clf_umbilical_ert_station";
	name = "\improper Umbillical Airlock"
	},
/turf/open/floor/plating,
/area/space)
"D" = (
/obj/effect/decal/warning_stripes{
	icon_state = "NE-out"
	},
/turf/open/floor/plating/almayer,
/area/space)
"E" = (
/obj/effect/decal/warning_stripes{
	icon_state = "N"
	},
/turf/open/floor/plating/almayer,
/area/space)
"G" = (
/turf/closed/shuttle/ert{
	icon_state = "leftengine_3";
	opacity = 0
	},
/area/space)
"J" = (
/turf/closed/shuttle/ert{
	icon_state = "leftengine_1";
	opacity = 0
	},
/area/space)
"K" = (
/turf/closed/shuttle/ert{
	icon_state = "rightengine_2"
	},
/area/space)
"L" = (
/turf/closed/shuttle/ert{
	icon_state = "stan27"
	},
/area/space)
"M" = (
/turf/closed/shuttle/ert{
	icon_state = "stan2"
	},
/area/space)
"O" = (
/turf/closed/shuttle/ert{
	icon_state = "stan21"
	},
/area/space)
"Q" = (
/turf/closed/shuttle/ert{
	icon_state = "stan_inner_t_right"
	},
/area/space)
"T" = (
/turf/closed/shuttle/ert{
	icon_state = "stan_leftengine"
	},
/area/space)
"U" = (
/turf/open/floor/plating/almayer,
/area/space)
"V" = (
/obj/effect/decal/warning_stripes{
	icon_state = "S"
	},
/turf/open/floor/plating/almayer,
/area/space)
"W" = (
/turf/closed/shuttle/ert{
	icon_state = "stan25"
	},
/area/space)
"X" = (
/turf/open/floor/plating,
/area/space)
"Y" = (
/turf/closed/shuttle/ert{
	icon_state = "stan_inner_s_w"
	},
/area/space)
"Z" = (
/turf/closed/shuttle/ert{
	icon_state = "rightengine_1"
	},
/area/space)

(1,1,1) = {"
a
a
a
a
a
a
a
a
a
a
a
a
a
a
a
a
a
a
a
a
a
a
a
a
a
a
a
a
a
a
a
a
a
a
a
a
a
a
a
a
"}
(2,1,1) = {"
a
a
a
a
a
a
a
a
a
a
a
a
a
a
a
a
a
a
a
a
a
a
a
a
a
a
a
a
a
a
a
a
a
a
a
a
a
a
a
a
"}
(3,1,1) = {"
a
a
a
a
a
a
a
a
a
a
a
a
a
a
a
a
a
a
a
a
a
a
a
a
a
a
a
a
a
a
a
a
a
a
a
a
a
a
a
a
"}
(4,1,1) = {"
a
a
a
a
a
a
a
a
a
a
a
c
d
d
d
d
d
d
d
T
G
z
J
a
a
a
a
a
a
a
a
a
a
a
a
a
a
a
a
a
"}
(5,1,1) = {"
a
a
a
a
a
a
a
a
a
a
c
k
U
U
U
U
U
U
U
o
T
G
z
J
a
a
a
a
a
a
a
a
a
a
a
a
a
a
a
a
"}
(6,1,1) = {"
a
a
a
a
a
a
a
a
a
c
k
U
U
U
U
U
U
U
U
U
o
T
G
z
J
a
a
a
a
a
a
a
a
a
a
a
a
a
a
a
"}
(7,1,1) = {"
a
a
a
a
a
a
a
a
c
k
U
U
U
U
U
U
U
U
U
U
U
M
a
a
a
a
a
a
c
d
d
d
T
G
z
J
a
a
a
a
"}
(8,1,1) = {"
a
a
a
a
a
a
a
a
O
U
U
U
U
U
U
U
U
U
U
U
U
M
a
a
a
a
a
a
O
U
U
U
o
T
G
z
J
a
a
a
"}
(9,1,1) = {"
a
a
a
a
a
a
a
a
O
U
U
U
U
U
U
U
U
U
U
U
O
o
d
d
f
a
a
a
O
U
U
U
U
o
T
G
z
J
a
a
"}
(10,1,1) = {"
a
a
a
a
a
a
a
c
k
t
t
t
t
t
t
t
t
t
t
t
O
U
U
U
Q
d
d
d
k
U
U
U
U
U
o
T
G
z
J
a
"}
(11,1,1) = {"
a
a
a
a
a
a
c
k
U
U
U
U
U
U
U
O
U
U
U
U
O
U
U
U
O
U
U
U
U
U
U
U
U
U
U
o
T
G
z
J
"}
(12,1,1) = {"
a
a
a
a
a
c
k
U
U
U
U
U
U
U
U
O
U
U
U
U
O
U
U
U
O
U
U
U
U
U
U
U
U
U
U
U
o
d
d
f
"}
(13,1,1) = {"
a
a
a
a
a
O
U
U
U
U
U
U
U
U
U
O
U
U
U
U
O
U
U
U
O
U
p
x
x
x
x
x
x
x
D
U
U
U
U
M
"}
(14,1,1) = {"
a
a
c
d
d
Y
U
U
U
U
U
U
U
U
U
O
U
U
U
U
O
U
U
U
O
U
V
X
X
X
X
X
X
r
E
U
U
U
U
C
"}
(15,1,1) = {"
a
a
O
U
U
O
t
t
t
t
t
t
t
t
t
O
U
U
U
U
O
t
t
t
O
U
V
X
X
X
X
X
X
X
E
U
U
U
U
C
"}
(16,1,1) = {"
c
d
k
U
U
O
U
U
U
U
U
U
U
U
U
O
t
t
t
t
O
U
U
U
O
U
V
X
X
X
X
X
X
X
E
U
U
U
U
C
"}
(17,1,1) = {"
L
U
U
U
U
O
X
X
X
X
X
X
X
X
X
X
X
X
X
X
U
U
U
U
U
U
V
X
X
X
X
X
X
X
E
U
U
U
U
C
"}
(18,1,1) = {"
O
U
U
U
U
O
X
X
X
X
X
X
X
X
X
X
X
X
X
X
U
U
U
U
U
U
V
X
X
X
X
X
X
X
E
U
U
U
U
C
"}
(19,1,1) = {"
L
U
U
U
U
O
U
U
U
U
U
U
U
U
U
U
U
U
U
U
O
U
U
U
O
U
V
X
X
X
X
X
X
X
E
U
U
U
U
C
"}
(20,1,1) = {"
L
U
U
U
U
O
U
U
U
U
U
U
U
U
U
U
U
U
U
U
O
t
t
t
O
U
V
X
X
X
X
X
X
X
E
U
U
U
U
C
"}
(21,1,1) = {"
L
U
U
U
U
O
U
U
U
U
U
U
U
U
U
U
U
U
U
U
O
U
U
U
O
U
V
X
X
X
X
X
X
X
E
U
U
U
U
C
"}
(22,1,1) = {"
O
U
U
U
U
O
X
X
X
X
X
X
X
X
X
X
X
X
X
X
U
U
U
U
U
U
V
X
X
X
X
X
X
X
E
U
U
U
U
C
"}
(23,1,1) = {"
L
U
U
U
U
O
X
X
X
X
X
X
X
X
X
X
X
X
X
X
U
U
U
U
U
U
V
X
X
X
X
X
X
X
E
U
U
U
U
C
"}
(24,1,1) = {"
W
b
l
U
U
O
U
U
U
U
U
U
U
U
U
O
t
t
t
t
O
U
U
U
O
U
V
X
X
X
X
X
X
X
E
U
U
U
U
C
"}
(25,1,1) = {"
a
a
O
U
U
O
t
t
t
t
t
t
t
t
t
O
U
U
U
U
O
t
t
t
O
U
V
X
X
X
X
X
X
X
E
U
U
U
U
C
"}
(26,1,1) = {"
a
a
W
b
b
Y
U
U
U
U
U
U
U
U
U
O
U
U
U
U
U
U
U
U
O
U
V
X
X
X
X
X
X
X
E
U
U
U
U
C
"}
(27,1,1) = {"
a
a
a
a
a
O
U
U
U
U
U
U
U
U
U
O
U
U
U
U
U
U
U
U
O
U
e
u
u
u
u
u
u
u
y
U
U
U
U
M
"}
(28,1,1) = {"
a
a
a
a
a
W
l
U
U
U
U
U
U
U
U
O
U
U
U
U
U
U
U
U
O
U
U
U
U
U
U
U
U
U
U
U
w
b
b
j
"}
(29,1,1) = {"
a
a
a
a
a
a
W
l
U
U
U
U
U
U
U
O
U
U
U
U
U
U
U
U
O
U
U
U
U
U
U
U
U
U
U
w
m
g
K
Z
"}
(30,1,1) = {"
a
a
a
a
a
a
a
W
l
U
U
U
U
U
U
O
U
U
U
U
U
U
U
U
v
b
b
b
l
U
U
U
U
U
w
m
g
K
Z
a
"}
(31,1,1) = {"
a
a
a
a
a
a
a
a
O
U
U
U
U
U
U
O
U
U
U
U
U
w
b
b
j
a
a
a
O
U
U
U
U
w
m
g
K
Z
a
a
"}
(32,1,1) = {"
a
a
a
a
a
a
a
a
O
U
U
U
U
U
U
O
U
U
U
U
U
M
a
a
a
a
a
a
O
U
U
U
w
m
g
K
Z
a
a
a
"}
(33,1,1) = {"
a
a
a
a
a
a
a
a
W
l
U
U
U
U
U
O
U
U
U
U
U
M
a
a
a
a
a
a
W
b
b
b
m
g
K
Z
a
a
a
a
"}
(34,1,1) = {"
a
a
a
a
a
a
a
a
a
W
l
U
U
U
U
O
U
U
U
U
w
m
g
K
Z
a
a
a
a
a
a
a
a
a
a
a
a
a
a
a
"}
(35,1,1) = {"
a
a
a
a
a
a
a
a
a
a
W
l
U
U
U
O
U
U
U
w
m
g
K
Z
a
a
a
a
a
a
a
a
a
a
a
a
a
a
a
a
"}
(36,1,1) = {"
a
a
a
a
a
a
a
a
a
a
a
W
b
b
b
b
b
b
b
m
g
K
Z
a
a
a
a
a
a
a
a
a
a
a
a
a
a
a
a
a
"}
(37,1,1) = {"
a
a
a
a
a
a
a
a
a
a
a
a
a
a
a
a
a
a
a
a
a
a
a
a
a
a
a
a
a
a
a
a
a
a
a
a
a
a
a
a
"}
(38,1,1) = {"
a
a
a
a
a
a
a
a
a
a
a
a
a
a
a
a
a
a
a
a
a
a
a
a
a
a
a
a
a
a
a
a
a
a
a
a
a
a
a
a
"}
(39,1,1) = {"
a
a
a
a
a
a
a
a
a
a
a
a
a
a
a
a
a
a
a
a
a
a
a
a
a
a
a
a
a
a
a
a
a
a
a
a
a
a
a
a
"}
(40,1,1) = {"
a
a
a
a
a
a
a
a
a
a
a
a
a
a
a
a
a
a
a
a
a
a
a
a
a
a
a
a
a
a
a
a
a
a
a
a
a
a
a
a
"}
